"","YQ","p","d","revenue","cost_of_revenue","gross_profit","operating_expenses","selling_general_administrative","research_development","depreciation_amortization","operating_income_loss","non_operating_income_loss","interest_expense_net","pretax_income_loss_adj","abnormal_gains_losses","pretax_income_loss","income_tax_expense_benefit_net","income_loss_from_continuing_operations","income_loss_incl_minority_interest","net_income","net_income_common","total_debt","gross_profit_margin","operating_margin","net_profit_margin","earnings_per_share_basic","earnings_per_share_diluted","sales_per_share"
"1","2010_Q2",45.1268253968254,"Down",243472000,-41338000,202134000,-107116000,-28170000,-14139000,-64807000,95018000,-20931000,-20931000,74087000,52631000,126718000,-49012000,77706000,77579000,77579000,77579000,0,0.83021,0.39026,0.31864,0.50208,0.4886,1.57573
"2","2010_Q3",35.64296875,"Down",195369000,-41204000,154165000,-118069000,-35836000,-14420000,-67813000,36096000,-21271000,-21271000,14825000,14584000,29409000,-11763000,17646000,9052000,9052000,9052000,-1.19209289550781e-07,0.7891,0.18476,0.04633,0.05858,0.0570100000000001,1.26441
"3","2010_Q4",38.96890625,"Up",210586000,-47936000,162650000,-121478000,-36523000,-15225000,-69730000,41172000,-23363000,-23363000,17809000,-14372000,3437000,-784000,2653000,-8168000,-8168000,-8168000,0,0.77237,0.19551,-0.03879,-0.05207,-0.05156,1.34239
"4","2011_Q1",47.6290322580645,"Up",235328000,-64501000,170827000,-129652000,-40042000,-16722000,-72888000,41175000,-25100000,-25100000,16075000,-36031000,-19956000,10649000,-9307000,-317719000,-317719000,-317719000,1960536000,0.72591,0.17497,-1.35011,-2.02531,-2.00545,1.50011
"5","2011_Q2",51.554126984127,"Up",215040000,-63199000,151841000,-133362000,-33959000,-27187000,-72216000,18479000,-24779000,-24779000,-6300000,-47028000,-53328000,19897000,-33431000,-25033000,-25033000,-25033000,0,0.70611,0.08593,-0.11641,-0.15957,-0.15801,1.37078
"6","2011_Q3",58.58890625,"Up",339898000,-67706000,272192000,-129006000,-39120000,-11592000,-78294000,143186000,-31383000,-31383000,111803000,-33324000,78479000,-32703000,45776000,51293000,51293000,51293000,0,0.8008,0.42126,0.15091,0.32697,0.32376,2.16669
"7","2011_Q4",64.3087301587302,"Up",373766000,-72909000,300857000,-147132000,-35907000,-17606000,-93619000,153725000,-34181000,-34181000,119544000,-63818000,55726000,-22540000,33186000,34755000,34755000,34755000,0,0.80493,0.41129,0.09299,0.21993,0.21798,2.36516
"8","2012_Q1",58.1093548387097,"Down",299679000,-69565000,230114000,-164279000,-42205000,-24982000,-97092000,65835000,-34709000,-34709000,31126000,-33740000,-2614000,-210999.999999996,-2825000,-2989000,-2989000,-2989000,1974967000,0.76787,0.21969,-0.00996999999999999,-0.01891,-0.01875,1.89634
"9","2012_Q2",57.6701587301587,"Down",261381000,-110538000,150843000,-160396000,-38729000,-21516000,-100151000,-9553000,-37205000,-37205000,-46758000,-22885000,-69643000,27843000,-41800000,-41800000,-41800000,-41800000,0,0.5771,-0.03655,-0.15992,-0.26451,-0.26217,1.654
"10","2012_Q3",62.5128571428571,"Up",452158000,-90062000,362096000,-168324000,-44005000,-15517000,-108802000,193772000,-42888000,-42888000,150884000,-56201000,94683000,-39007000,55676000,55676000,55676000,55676000,0,0.80082,0.42855,0.12313,0.35231,0.3492,2.86122
"11","2012_Q4",64.1,"Up",298831000,-94934000,203897000,-182308000,-44497000,-14752000,-123059000,21589000,-43997000,-43997000,-22408000,-60502000,-82910000,29074000,-53836000,-53836000,-53836000,-53836000,0,0.68232,0.07224,-0.18016,-0.33768,-0.33583,1.87436
"12","2013_Q1",69.626,"Up",396202000,-100370000,295832000,-177820000,-46582000,-18022000,-113216000,118012000,-44708000,-44708000,73304000,9622000,82926000,-29964000,52962000,52962000,52962000,52962000,2878185000,0.74667,0.29786,0.13367,0.33219,0.33038,2.4851
"13","2013_Q2",73.425625,"Up",319405000,-126302000,193103000,-215939000,-84058000,-16780000,-115101000,-22836000,-42210000,-42210000,-65046000,-57744000,-122790000,47180000,-75610000,-75610000,-75610000,-75610000,0,0.60457,-0.0715,-0.23672,-0.47425,-0.47166,2.00341
"14","2013_Q3",75.15578125,"Up",590069000,-126459000,463610000,-235050000,-101987000,-13068000,-119995000,228560000,-45071000,-45071000,183489000,57988000,241477000,-97494000,143983000,143983000,143983000,143983000,4.76837158203125e-07,0.78569,0.38734,0.24401,0.90311,0.898170000000001,3.70109
"15","2013_Q4",74.89015625,"Down",436030000,-154436000,281594000,-195758000,-44919000,-20496000,-130343000,85836000,-44321000,-44321000,41515000,-10471000,31044000,-11866000,19178000,19178000,19178000,19178000,0,0.64581,0.19686,0.04398,0.11954,0.11882,2.71775
"16","2014_Q1",82.0203278688525,"Up",424924000,-154162000,270762000,-201230000,-60207000,-14065000,-126958000,69532000,-44955000,-44955000,24577000,-24729000,-152000.00000003,28323000,28171000,28171000,28171000,28171000,3140516000,0.6372,0.16363,0.0663,0.17559,0.17453,2.64852
"17","2014_Q2",86.2504761904762,"Up",457695000,-159763000,297932000,-192740000,-49212000,-14846000,-128682000,105192000,-45401000,-45401000,59791000,-8313000,51478000,-18957000,32521000,32521000,32521000,32521000,0,0.65094,0.22983,0.07105,0.2027,0.20148,2.85278
"18","2014_Q3",73.57234375,"Down",483460000,-157363000,326097000,-203870000,-56888000,-13621000,-133361000,122227000,-45488000,-45488000,76739000,212626000,289365000,-117976000,171389000,171389000,171389000,171389000,-4.76837158203125e-07,0.67451,0.25282,0.35451,1.06826,1.06184,3.01338
"19","2014_Q4",62.36671875,"Down",616448000,-161385000,455063000,-208856000,-54963000,-11443000,-142450000,246207000,-39188000,-39188000,207019000,32921000,239940000,-93522000,146418000,146418000,146418000,146418000,0,0.7382,0.3994,0.23752,0.89484,0.8906,3.76744
"20","2015_Q1",47.9116393442623,"Down",868454000,-171796000,696658000,-222540000,-52363000,-23638000,-146539000,474118000,-38900000,-38900000,435218000,14884000,450102000,-166048000,284054000,284054000,284054000,284054000,3030824000,0.80218,0.54593,0.32708,1.73601,1.72779,5.30759
"21","2015_Q2",55.164126984127,"Up",462807000,-158053000,304754000,-203505000,-48329000,-7886000,-147290000,101249000,-39207000,-39207000,62042000,-11992000,50050000,-22366000,27684000,27684000,27684000,27684000,0,0.65849,0.21877,0.05982,0.16919,0.16839,2.82846
"22","2015_Q3",37.74625,"Down",244601000,-166251000,78350000,-212884000,-55964000,-5025000,-151895000,-134534000,-43479000,-43479000,-178013000,-2556000,-180569000,61975000,-118594000,-118594000,-118594000,-118594000,0,0.32032,-0.55001,-0.48485,-0.72479,-0.72136,1.49489
"23","2015_Q4",28.74546875,"Down",479933000,-174359000,305574000,-204406000,-46178000,-4235000,-153993000,101168000,-42904000,-42904000,58264000,-493993000,-435729000,134781000,-300948000,-300948000,-300948000,-300948000,0,0.6367,0.2108,-0.62706,-1.8087,-1.8087,2.8844
"24","2016_Q1",26.963606557377,"Down",410727000,-184165000,226562000,-175781000,-43544000,-4260000,-127977000,50781000,-40849000,-40849000,9932000,-496046000,-486114000,164287000,-321827000,-321827000,-321827000,-321827000,2651303000,0.55161,0.12364,-0.78355,-1.93418,-1.93418,2.46847
"25","2016_Q2",39.74109375,"Up",331413000,-191762000,139651000,-166131000,-40657000,-4913000,-120561000,-26480000,-37739000,-37739000,-64219000,-71529000,-135748000,41976000,-93772000,-93772000,-93772000,-93772000,0,0.42138,-0.0799,-0.28295,-0.56217,-0.56217,1.98685
"26","2016_Q3",39.27484375,"Down",101797000,-204489000,-102692000,-175239000,-46064000,-6785000,-122390000,-277931000,-37758000,-37758000,-315689000,-38735000,-354424000,129488000,-224936000,-224936000,-224936000,-224936000,0,-1.00879,-2.73025,-2.20965,-1.34591,-1.34591,0.6091
"27","2016_Q4",34.7580952380952,"Down",413207000,-212490000,200717000,-179456000,-41024000,-6943000,-131489000,21261000,-45967000,-45967000,-24706000,-30970000,-55676000,13705000,-41971000,-41971000,-41971000,-41971000,0,0.48575,0.05145,-0.10157,-0.23229,-0.23229,2.28692
"28","2017_Q1",30.0238709677419,"Down",253522000,-247875000,5647000,-220373000,-57027000,-13684000,-149662000,-214726000,-46749000,-46749000,-261475000,5185000,-256290000,95581000,-160709000,-160709000,-160709000,-160709000,3773517000,0.0222699999999996,-0.84697,-0.63391,-0.65633,-0.65633,1.03538
"29","2017_Q2",24.5261904761905,"Down",776655000,-268384000,508271000,-205821000,-47496000,-8504000,-149821000,302450000,-47101000,-47101000,255349000,27157000,282506000,-112395000,170111000,170111000,170111000,170111000,3738795000,0.65444,0.38943,0.21903,0.69532,0.69489,3.17453
"30","2017_Q3",18.818253968254,"Down",673111000,-288836000,384275000,-219324000,-52322000,-14498000,-152504000,164951000,-47926000,-47926000,117025000,10176000,127201000,-57651000,69550000,69550000,69550000,69550000,3848589000,0.57089,0.24506,0.10333,0.28367,0.28349,2.74541
"31","2017_Q4",17.5349206349206,"Down",482232000,-300299000,181933000,-235551000,-53035000,-22767000,-159749000,-53618000,-49179000,-49179000,-102797000,-96895000,-199692000,71992000,-127700000,-127700000,-127700000,-127700000,3981962000,0.37727,-0.11119,-0.26481,-0.52071,-0.52071,1.96634
"32","2018_Q1",14.5854098360656,"Down",679032000,-301109000,377923000,-251364000,-80553000,-7893000,-162918000,126559000,-51473000,-51473000,75086000,-202981000,-127895000,349080000,221185000,221185000,221185000,221185000,4108806000,0.55656,0.18638,0.32574,0.90172,0.89748,2.76827
"33","2018_Q2",14.7884375,"Up",742599000,-348270000,394329000,-238402000,-68417000,-7719000,-162266000,155927000,-52385000,-52385000,103542000,-11628000,91914000,-42676000,49238000,49238000,49238000,49238000,4081694000,0.53101,0.20997,0.0663,0.20039,0.19967,3.02227
"34","2018_Q3",15.7092063492063,"Up",656184000,-417885000,238299000,-216108000,-47583000,-7499000,-161026000,22191000,-53862000,-53862000,-31671000,-76683000,-108354000,28518000,-79836000,-79836000,-79836000,-79836000,4207162000,0.36316,0.03382,-0.12167,-0.32469,-0.32469,2.66872
"35","2018_Q4",14.8936507936508,"Down",811225000,-460995000,350230000,-216287000,-43722000,-8299000,-164266000,133943000,-54801000,-54801000,79142000,-6466000,72676000,-24137000,48539000,48539000,48539000,48539000,4160900000,0.43173,0.16511,0.05983,0.19695,0.19638,3.29163
"36","2019_Q1",10.6440983606557,"Down",1072637000,-572393000,500244000,-208599000,-50090000,-10600000,-147909000,291645000,-49161000,-49161000,242484000,-2075690000,-1833206000,68784000,-1764422000,-1764422000,-1764422000,-1764422000,3836861000,0.46637,0.2719,-1.64494,-7.15372,-7.20043,4.34893
"37","2019_Q2",8.54269841269841,"Down",748137000,-479497000,268640000,-193567000,-46638000,-8211000,-138718000,75073000,-51537000,-51537000,23536000,-16429000,7107000,-5688000,1419000,1419000,1419000,1419000,3790649000,0.35908,0.10035,0.0019,0.00573,0.0057,3.01941
"38","2019_Q3",4.73515625,"Down",851429000,-446206000,405223000,-200245000,-50631000,-8109000,-141505000,204978000,-51727000,-51727000,153251000,2033000.00000024,155284000,-40099000,115185000,115185000,115185000,115185000,3792455000,0.47593,0.24075,0.13528,0.464889999999999,0.462719999999999,3.43637
"39","2019_Q4",3.99859375,"Down",622445000,-418931000,203514000,-189811000,-41047000,-11013000,-137751000,13703000,-46997000,-46997000,-33294000,-41506000,-74800000,47219000,-27581000,-27581000,-27581000,-27581000,3133990000,0.32696,0.02201,-0.04431,-0.11117,-0.11104,2.50897
"40","2020_Q1",3.16854838709677,"Down",605604000,-350831000,254773000,-220979000,-42793000,-9350000,-130869000,33794000,-44024000,-44024000,-10230000,-2293949000,-2304179000,498859000,-1805320000,-1805320000,-1805320000,-1805320000,3172937000,0.42069,0.0558,-2.98102,-7.2723,-7.35631,2.43953
"41","2020_Q2",5.51761904761905,"Up",693920000,-358443000,335477000,-152317000,-42254000,-7077000,-102986000,183160000,-47518000,-47518000,135642000,59551000,195193000,-28998000,166195000,166195000,166195000,166195000,3187029000,0.48345,0.26395,0.2395,0.67499,0.671,2.81832
"42","2020_Q3",7.20703125,"Up",376546000,-346987000,29559000,-150941000,-38288000,-8027000,-104626000,-121382000,-48624000,-48624000,-170006000,-19842999.9999998,-189849000,22266000,-167583000,-167583000,-167583000,-167583000,3224467000,0.0785,-0.32236,-0.44505,-0.700550000000001,-0.70487,1.57408
"43","2020_Q4",7.306875,"Up",299345000,-341696000,-42351000,-142406000,-38153000,-8086000,-96167000,-184757000,-47999000,-47999000,-232756000,-552543000,-785299000,36509000,-748790000,-748790000,-748790000,-748790000,3087466000,-0.14148,-0.6172,-2.50143,-3.12157,-3.12157,1.24792
"44","2021_Q1",9.65770491803279,"Up",598886000,-321837000,277049000,-165352000,-40720000,-9464000,-90551000,111697000,-48526000,-48526000,63171000,-20545000,42626000.0000001,-4225000,38400999.9999999,38400999.9999999,38400999.9999999,38400999.9999999,3085608000,0.46261,0.18651,0.06412,0.15988,0.15988,2.49347
"45","2021_Q2",12.4809523809524,"Up",626032000,-364315000,261717000,-136550000,-38004000,-5538000,-88383000,125167000,-56878000,-56878000,68289000,-38449000,29840000,-2689000,27151000,27151000,27151000,27151000,3100594000,0.41806,0.19994,0.04337,0.11249,0.11249,2.59363
"46","2021_Q3",16.1221875,"Up",434722000,-371606000,63116000,-144313000,-40242000,-5028000,-90629000,-81197000,-57287000,-57287000,-138484000,-19250000,-157734000,1262000,-156472000,-156472000,-156472000,-156472000,3036657000,0.14519,-0.18678,-0.35994,-0.64557,-0.64557,1.79358
"47","2021_Q4",21.43953125,"Up",302639000,-422593000,-119954000,-155198000,-49061000,-5881000,-93116000,-275152000,-56809000,-56809000,-331961000,-47989000,-379950000,29683000,-350267000,-350267000,-350267000,-350267000,2948380000,-0.39636,-0.90918,-1.15738,-1.43952,-1.43952,1.24378
"48","2022_Q1",22.6929032258065,"Up",1566830000,-458530000,1108300000,-151132000,-42459000,-7108000,-92427000,957168000,-56362000,-56362000,900806000,9073000.00000001,909879000,-18513000,891366000,891366000,891366000,891366000,2925787000,0.70735,0.61089,0.5689,3.63574,3.63574,6.39084
"49","2022_Q2",30.4624193548387,"Up",180736000,-411198000,-230462000,-139919000,-43026000,-4699000,-85604000,-370381000,-47175000,-47175000,-417556000,-155333000,-572889000,116081000,-456808000,-456808000,-456808000,-456808000,2579217000,-1.27513,-2.04929,-2.52749,-1.87702,-1.82401,0.74264
"50","2022_Q3",30.09671875,"Down",1225143000,-458066000,767077000,-144965000,-43493000,-7506000,-86498000,622112000,-42001000,-42001000,580111000,-23925000,556186000,-103331000,452855000,452855000,452855000,452855000,2362141000,0.62611,0.507789999999999,0.36963,1.85984,1.82125,5.03155
